0000010000000000100000
0001111000000011110000
0000112000000000111110
0020002220000001120000
0000011111000011110000
0000111111000000111110
0000112000000000111110
0020002220000001120000
0000011111000011110000
0000111111000000111110
0000112000000000111110
0020002220000001120000
0000011111000011110000
0000111111000000111110